4 4 4 4 4 4 4 4 4 4 4 1 6 6 6 6 6 6 6 6 6 6 6 6 6 6 6 6 6 6 6 6 6 6 6 6 6 1 1 4 4 4 4 4 4 4 4 4 4 4
4 4 4 4 4 4 4 4 4 4 4 1 6 6 3 3 3 3 6 6 6 3 3 3 3 3 3 3 6 6 3 3 6 6 3 3 3 1 1 4 4 4 4 4 4 4 4 4 4 4
4 4 4 4 4 4 4 8 8 8 4 1 1 3 3 3 3 3 3 3 3 3 3 3 3 3 3 3 3 6 3 3 3 3 6 6 3 1 1 4 4 4 4 4 4 4 4 4 4 4
4 4 8 4 4 4 8 8 8 8 4 1 1 3 3 3 1 1 3 1 1 1 1 1 1 1 1 1 3 1 3 3 3 3 3 3 3 1 1 4 4 4 4 4 4 4 4 4 4 4
4 8 8 8 8 8 4 8 8 8 4 1 1 3 3 3 1 3 3 3 3 3 3 3 3 1 1 3 3 1 3 1 3 3 3 3 3 1 1 4 4 4 4 4 4 4 4 4 4 4
4 8 4 8 4 8 4 8 4 8 4 1 1 3 3 3 1 3 3 3 3 3 3 3 3 1 1 3 1 1 3 1 3 3 3 3 3 1 1 4 4 4 4 4 4 4 4 4 4 4
4 8 4 4 4 8 4 8 4 8 4 1 1 3 3 3 1 3 3 3 3 3 3 3 3 1 1 3 3 3 3 1 3 3 3 3 3 1 1 4 4 4 4 4 4 4 4 4 4 4
4 8 4 4 4 8 8 8 4 8 4 1 1 1 1 1 1 1 1 1 1 1 3 1 1 1 1 1 1 1 1 1 1 1 1 1 1 1 1 4 4 4 4 4 4 4 4 4 4 4
4 8 4 4 4 4 4 4 4 8 4 1 1 1 1 1 1 1 1 1 1 1 3 1 1 1 1 1 1 1 1 1 1 1 1 1 1 1 1 5 5 5 4 4 4 4 4 4 4 4
4 8 4 4 4 4 4 4 4 0 0 0 0 0 4 4 4 0 0 0 0 0 0 0 0 0 0 0 0 0 0 0 0 0 0 0 2 5 5 5 5 5 4 4 4 4 4 4 4 4
4 8 4 4 4 4 4 4 0 0 0 0 0 4 4 4 4 0 0 0 0 0 0 0 0 0 0 0 0 0 0 0 0 0 0 2 2 2 5 5 5 5 4 4 4 4 4 4 4 4
4 8 4 4 4 4 4 4 0 0 0 0 0 4 4 4 0 0 0 0 0 0 0 0 0 0 0 0 0 0 0 0 0 0 2 2 2 2 2 2 2 5 8 8 8 8 8 8 8 4
4 8 4 4 4 4 4 4 0 2 0 0 0 0 4 4 0 0 0 0 0 0 0 0 0 0 0 0 0 0 0 0 0 0 0 0 0 2 2 2 2 2 4 4 4 4 4 4 8 4
4 8 4 4 4 4 4 4 0 2 2 2 2 2 4 4 0 0 0 4 0 0 0 0 0 0 0 0 0 0 0 0 0 0 0 0 0 0 0 0 2 2 4 4 4 4 4 4 8 4
4 8 4 4 4 4 4 4 0 0 0 0 0 0 0 4 0 0 0 4 4 0 0 0 4 4 4 4 4 4 4 4 4 4 4 0 0 0 0 0 0 0 4 4 4 4 4 4 8 4
4 8 4 4 4 4 4 4 0 2 2 2 2 2 0 4 0 0 0 0 4 0 0 0 0 0 0 0 0 0 0 0 0 4 4 0 0 0 0 0 0 0 4 4 4 4 4 4 8 4
4 8 4 4 4 4 4 4 2 2 0 0 2 0 0 4 0 0 0 0 4 0 0 0 0 0 0 0 0 0 0 0 0 0 4 0 0 4 4 0 0 0 4 4 4 4 4 4 8 4
4 8 4 4 4 4 4 4 2 2 0 0 0 0 0 4 0 0 0 0 4 0 0 0 0 0 2 2 2 0 0 0 0 0 4 0 0 4 4 0 0 0 4 4 4 4 4 4 8 4
4 8 4 4 4 4 4 4 2 2 2 2 0 2 2 4 0 0 4 0 4 4 0 0 0 2 2 2 2 2 0 0 0 0 4 0 0 0 4 0 0 0 4 4 4 4 4 4 8 4
4 8 4 4 4 4 4 4 2 2 2 0 0 2 2 4 0 4 4 0 4 0 0 0 0 0 2 0 2 2 2 0 0 0 4 0 0 0 0 0 0 0 4 4 4 4 4 4 8 4
4 8 4 4 4 4 4 4 0 2 2 0 0 0 0 4 0 0 4 0 4 0 0 0 0 0 0 0 0 2 2 0 0 0 4 0 0 0 0 0 0 0 4 4 4 4 4 4 8 4
4 8 4 4 4 4 4 4 0 0 0 0 0 0 4 4 0 0 0 0 4 0 0 0 4 0 0 0 4 4 2 0 0 0 4 4 0 0 0 4 0 0 4 4 4 4 4 4 8 4
4 8 4 4 4 4 4 4 0 0 0 2 2 0 4 4 0 0 0 0 0 4 4 4 4 4 4 4 4 0 0 0 0 0 0 4 0 0 0 4 0 0 4 4 4 4 4 4 8 4
4 8 4 4 4 4 4 4 0 0 0 0 2 2 4 4 4 0 0 0 0 4 4 4 4 4 4 4 4 4 0 0 0 0 0 4 4 4 4 4 0 0 4 4 4 4 4 4 8 4
4 8 4 4 4 4 4 4 2 2 0 0 0 2 4 4 4 0 0 0 4 4 4 0 0 0 0 0 4 4 4 0 0 0 0 0 4 0 0 0 0 0 4 4 4 4 4 4 8 4
4 8 4 4 4 4 4 4 2 2 2 4 0 0 0 4 0 0 0 0 4 4 0 0 0 0 0 0 0 0 4 0 0 0 0 0 4 0 0 0 0 0 4 4 4 4 4 4 8 4
4 8 4 4 4 4 4 4 0 0 0 4 2 2 0 4 0 0 0 0 4 0 0 0 0 0 0 0 4 0 4 4 4 0 0 0 4 0 0 0 0 0 4 4 4 4 4 4 8 4
4 8 4 4 4 4 4 4 0 0 0 4 0 0 0 4 0 4 0 0 4 0 0 4 0 0 0 0 0 0 0 4 4 0 4 0 4 0 0 0 0 0 4 4 4 4 4 4 8 4
4 8 4 4 4 4 4 4 0 0 0 4 0 0 0 4 0 0 0 0 4 0 0 0 0 0 0 0 0 0 0 4 4 0 0 0 4 0 0 0 0 0 4 4 4 4 4 4 8 4
4 8 4 4 4 4 4 4 4 4 4 4 0 0 0 4 0 0 0 0 4 4 0 0 4 0 0 4 0 0 0 0 0 0 0 0 4 0 0 0 0 0 4 4 4 4 4 4 8 4
4 8 4 4 4 4 4 4 0 0 0 0 0 0 0 0 0 0 4 0 0 4 4 0 0 0 0 0 0 0 0 0 0 0 0 0 4 0 0 0 0 0 4 4 4 4 4 4 8 4
4 8 4 4 4 4 4 4 0 0 4 0 0 0 0 0 0 0 0 0 0 0 4 4 4 4 4 4 4 4 4 4 4 4 4 4 4 4 4 4 4 4 4 4 4 4 4 4 8 4
4 8 4 4 4 4 4 4 0 0 0 0 0 0 0 4 4 4 0 0 0 2 2 2 2 2 2 2 2 2 2 0 0 0 0 2 2 2 2 2 2 0 4 4 4 4 4 4 8 4
4 8 4 4 4 4 4 4 0 0 0 4 4 4 4 4 4 4 4 4 2 2 2 2 7 7 7 7 7 7 7 7 7 7 7 7 7 7 7 2 0 0 4 4 4 4 4 4 8 4
4 8 4 4 4 4 4 4 0 4 0 4 0 0 0 4 0 0 0 0 0 2 2 2 7 3 3 3 3 3 7 3 3 7 3 3 3 3 7 2 0 0 4 4 4 4 4 4 8 4
4 8 4 4 4 4 4 4 0 0 0 4 0 4 0 4 0 0 0 0 0 0 0 0 7 3 7 7 7 3 7 7 3 3 3 7 7 3 7 0 0 0 4 4 4 4 4 4 8 4
4 8 4 4 4 4 4 4 0 0 0 0 0 4 0 0 0 0 0 0 0 0 0 0 7 3 7 3 3 3 3 3 3 7 3 7 3 7 7 0 0 0 4 4 4 4 4 4 8 4
4 8 4 4 4 4 4 4 4 4 4 4 4 4 4 4 4 4 4 0 0 0 0 0 3 3 3 7 7 3 7 7 3 7 3 7 3 3 3 0 0 0 4 4 4 4 4 4 8 4
4 8 4 4 4 4 4 4 0 0 0 0 0 4 0 0 0 0 0 0 0 0 0 0 7 7 3 7 3 3 7 3 7 7 3 3 3 7 7 0 0 0 4 4 4 4 4 4 8 4
4 8 4 4 4 4 4 4 0 0 0 0 0 4 0 0 0 0 0 4 0 0 0 0 7 3 3 3 7 7 3 3 3 7 7 7 7 3 7 0 0 0 4 4 4 4 4 4 8 4
4 8 4 4 4 4 4 4 0 0 0 0 0 4 0 0 4 0 0 0 0 2 2 0 7 3 7 3 3 3 3 7 3 3 3 3 3 3 7 2 0 0 4 4 4 4 4 4 8 4
4 8 4 4 4 4 4 4 0 0 0 0 0 4 0 0 0 0 0 0 2 2 2 2 7 7 7 7 7 7 7 7 7 7 7 7 7 7 7 2 2 0 8 8 8 8 8 8 8 4
4 8 4 4 4 4 4 4 4 4 8 4 4 4 4 4 4 4 4 4 4 4 4 4 4 4 4 0 0 0 0 0 0 0 0 0 4 4 4 4 4 4 4 4 4 4 4 4 4 4
4 8 4 4 4 4 4 4 4 4 8 4 4 4 4 4 4 4 4 4 4 4 4 4 4 4 4 4 4 4 4 4 4 0 0 4 4 4 4 4 4 4 4 4 4 4 4 4 4 4
4 8 8 4 4 4 4 4 4 4 8 4 4 4 4 4 4 4 4 4 4 4 4 4 4 4 4 4 4 4 4 4 4 4 4 4 4 4 4 4 4 4 4 4 4 4 4 4 4 4
4 4 8 4 4 4 4 4 4 4 8 4 4 4 4 4 4 4 4 4 4 4 4 4 4 4 4 4 4 4 4 4 4 4 4 4 4 4 4 4 4 4 4 4 4 4 4 4 4 4
4 4 8 8 8 4 8 8 8 4 8 4 4 4 4 4 4 4 4 4 4 4 4 4 4 4 4 4 4 4 4 4 4 4 4 4 4 4 4 4 4 4 4 4 4 4 4 4 4 4
4 8 8 4 8 8 8 4 8 4 8 4 4 4 4 4 4 4 4 4 4 4 4 4 4 4 4 4 4 4 4 4 4 4 4 4 4 4 4 4 4 4 4 4 4 4 4 4 4 4
4 4 8 4 8 4 8 4 8 8 8 4 4 4 4 4 4 4 4 4 4 4 4 4 4 4 4 4 4 4 4 4 4 4 4 4 4 4 4 4 4 4 4 4 4 4 4 4 4 4
4 4 4 4 4 4 4 4 4 4 4 4 4 4 4 4 4 4 4 4 4 4 4 4 4 4 4 4 4 4 4 4 4 4 4 4 4 4 4 4 4 4 4 4 4 4 4 4 4 4